2 3 4 5 4 3 2 5 4 3 5 4 2  
4 0 0 1 0 5 0 1 0 1 0 0 4  
3 1 2 3 2 1 3 5 3 2 2 1 3  
5 2 0 1 0 4 0 1 0 1 0 3 5  
4 1 2 4 3 1 5 2 3 4 2 1 4  
2 3 4 5 4 3 2 5 4 3 5 4 2