2 2 2 2 2 2 2 2 2 2 2 2
3 2 3 2 3 0 0 2 3 2 3 2
3 3 1 1 3 0 0 3 1 1 3 3
4 5 4 5 4 0 0 5 4 5 4 5
5 5 5 5 5 5 5 5 5 5 5 5