2 3 4 5 2 3 4 5 2 3 4 5
3 1 0 0 1 0 0 1 0 0 1 2
4 0 2 0 1 0 0 1 0 5 0 4
5 0 0 1 1 1 1 1 0 0 0 3
4 0 5 0 1 0 0 1 0 2 0 4
3 1 0 0 1 0 0 1 0 0 1 2
2 3 4 5 2 3 4 5 2 3 4 5