2 3 4 5 2 3 4 5 4 3 2 5 4 3 2
3 1 0 0 1 0 1 0 1 0 0 0 1 0 3
4 0 2 0 1 1 0 0 0 1 1 0 2 0 4
5 0 0 1 0 0 1 0 1 0 0 1 0 0 5
4 1 5 0 1 0 0 0 0 0 1 0 5 1 4
3 0 1 1 1 1 0 1 0 1 1 1 1 0 3
4 1 5 0 1 0 0 0 0 0 1 0 5 1 4
5 0 0 1 0 0 1 0 1 0 0 1 0 0 5
4 0 2 0 1 1 0 0 0 1 1 0 2 0 4
3 1 0 0 1 0 1 0 1 0 0 0 1 0 3
2 3 4 5 2 3 4 5 4 3 2 5 4 3 2