0 0 0 0 0 0 0 5 5 0 0 0 0 0 0 0 
0 0 0 4 4 0 0 3 3 0 0 4 4 0 0 0
0 0 0 5 4 0 0 3 3 0 0 4 5 0 0 0
0 0 0 0 5 4 4 3 3 4 4 5 0 0 0 0
0 0 0 0 0 5 4 4 4 4 5 0 0 0 0 0
0 0 0 0 0 0 0 3 3 0 0 0 0 0 0 0
0 0 0 0 0 0 3 4 4 3 0 0 0 0 0 0
0 3 3 3 0 0 0 0 0 0 0 0 3 3 3 0
2 1 1 1 0 0 0 0 0 0 0 0 1 1 1 2
2 1 0 1 3 4 4 4 4 4 4 3 1 0 1 2
2 1 0 1 1 1 1 5 5 1 1 1 1 0 1 2
2 1 0 0 0 0 0 0 0 0 0 0 0 0 1 2
1 1 0 0 0 0 0 0 0 0 0 0 0 0 1 1