3 3 3 3 3 4 4 3 3 3 3 3
3 3 6 3 3 4 4 2 2 3 4 5
2 2 2 2 2 0 0 2 2 2 2 2
3 3 3 3 3 4 4 3 3 3 3 3
1 1 1 1 1 1 0 1 1 1 1 1